###########################################
#   #         # #                         #
# # # ### ### # # ############### ####### #
# #     # #     #   #   #       # #   #   #
# ####### ######### # # # ##### # ### # ###
#   #   # #   #     # #   # #   #     #   #
### # # # # # # ##### ##### # ########### #
#   # #   # #   #   # #  X  #             #
##### ##### ##### ### # # # ############# #
#     #     #   #   # # # # #           # #
# ##### ##### # ### # ### ### # ######### #
#   #   #     #   # #   # #   #           #
# # # ##### ##### # ### # # ###############
# # # #     #       #   #   #   #         #
### # # ########### # ### ### # ### ##### #
#   # # #   #   #   #   #   # # #   #   # #
# ### # # # # # ####### ### # # # ### # ###
#   # # # #   #         #   # # #     #   #
# # # # # # ############# ### # ######### #
# # #   # # #       #     #   # #       # #
# # ### # ### ##### # ##### ### # ##### # #
# #   # #   # # #   #     # # # #     # # #
### ### ### # # # # ##### # # # ##### # # #
#   #     # #   # # #   #   # #       #   #
# ### ##### # ### ### # ##### ########### #
# #   #   #   #   #   #     #     #     # #
# # ### # ##### ### ####### # ### # # ### #
# # #   #   #   #   # #     #   # # #     #
# # # ##### # ### ### # ##### # ### #######
# # #     #   #   #   #     # #           #
# # ##### ##### ##### ##### # ########### #
#   #   #     #         #   # #       # # #
# ### # ##### ######### # ### # ##### # # #
#   # # #   #           # #   # # #   #   #
### # # # # ############# ##### # # #######
#   # #   #         #     #     # #       #
# ########### ##### # ##### ##### #########
# #   #     #   #   #     # #         #   #
# # # # ### ### # ####### # # # ##### # # #
#   # #   #   # #       #   # # #   #   # #
##### ### ### ##### ### ####### # # ##### #
#   # #   # #   #   # # #       # #  O  # #
# ### # ### ### # ### # ### ##### ##### # #
#       #         #         #         #   #
###########################################